111111111111111111111
1                   1
1x                  1
1                   1
1                   1
1                   1
111111111111111111111